##########
#        #
# #C## # #
#   X s  #
# ### O#X#
#     O###
#   O    #
#b     C #
#     E  #
##########